111111111111111
1000100P0010001
100010000010001
100010000010001
100C01111100001
100E00000000001
100000000000001
111111111111111