11111111111111111111111111
10000000000000000000000001
10000000000000000000000001
10000000000000000000000001
10000000000000000000000001
10000000000000000000000001
10000000000000000000000001
10000000000000000000000001
10000000000000000000000001
100000000P000000000E000001
10000010000000000000000001
10000010000000000000000001
10000001100000000000000001
10000000000100000000000001
10000000000000000000000001
10000000000000000000000001
1000000000000000C000000001
10000000000000000000000001
10000000000000000000000001
10000000000000000000000001
10000000000000000000001111
11111111111111111111111111