1111111111111111111111111111111111
1E0000000000000C000C0C0000000000C1
10100101001000001010010C0000010101
1010C1001010101C001001000C00010101
1P00000C0C00C10000000100000C0000C1
1111111111111111111111111111111111