111111111111111
100000000000001
1P0011E00000001
100000000000001
1000000000C0001
10C000000000001
111111111111111