1111111111
1000000001
1P0011E001
100000P001
1111111111