11111111111111111111111111
1C0C0C0C0C0C110C0C0C0C0C01
101111C1111011C111101111C1
1C111101111C1101111C111101
101111C1111011C111101111C1
1C0C0C0C0C0C0C0C0C0C0C0C01
101111C1C111111110101111C1
1C0C0C010C0C110C0C1C0C0C01
111111C1111011011110111111
1111110100000000001C111111
111111C1011100111010111111
1E00000001000000100C0000E1
111111C1011111111010111111
1111110100000000001C111111
111111C1011111111010111111
1C0C0C0C0C0C110C0C0C0C0C01
101111C1111011C111101111C1
1C0C110C0C0C0P0C0C0C110C01
111011C1C1111111101011C111
1C0C0C010C0C110C0C1C0C0C01
10111111111011C111111111C1
1C0C0C0C0C0C0C0C0C0C0C0C01
11111111111111111111111111